......................
......................
......................
........bbb...........
........b.bb..........
.......bb..bb.........
......bb....b.........
......b.....bb........
......b......b........
......b......b........
......bbbbbbbb........
......................