......................
......................
.......1------2.......
.......[......].......
.......[......].......
.......[......].......
.......[......].......
.......3______4.......
......@...............
................1-----
................[.....
................[.....